20 20
100 100
2  4  5  4  5  4  5  4  5  4  5  4  5  4  5  4  5  4  5  2
3  0  0  0  0  0  0  0  0  0  0  0  0  0  0  0  0  0  1  2
2  0  0  0  2  2  2  2  2  2  2  2  2  2  0  0  0  0  1  3
3  0  0  0  2  0  0  0  0  0  0  0  0  2  0  0  0  0  1  2
2  0  0  0  1  1  1  1  1  1  1  1  1  1  0  0  0  0  1  2
2  0  0  0  2  1  1  1  1  1  1  0  0  2  0  0  0  0  1  2
3  0  0  0  2  0  1  1  1  1  1  1  0  2  0  0  0  0  1  3
2  0  0  0  2  0  0  1  1  1  1  2  2  2  0  0  0  0  1  2
2  1  0  0  2  0  1  1  1  1  1  2  2  2  0  0  0  0  1  2
2  1  0  0  2  2  2  2  1  1  1  2  2  2  0  0  0  0  1  2
2  1  0  0  2  2  2  2  2  2  0  2  2  2  0  0  0  0  1  2
2  1  0  0  0  0  0  0  0  0  0  0  0  0  0  0  0  0  1  2
2  1  0  0  0  0  0  0  0  0  0  0  0  0  0  0  0  0  1  3
2  1  0  0  0  0  1  1  1  1  1  1  0  0  0  0  2  2  1  2
2  1  0  0  0  0  0  0  1  1  1  0  0  0  0  2  2  0  1  2
2  1  0  0  0  0  0  0  0  1  0  1  1  0  2  2  0  0  1  2
2  1  0  0  0  0  0  0  1  1  1  1  1  1  2  0  0  0  1  3
2  1  0  0  0  0  0  0  1  1  0  1  1  1  1  0  0  0  1  2
2 11 11 11 11 11 11 11 11 11 11 11 11 11 11 11 11 11 11  2
2  2  2  2  3  2  2  3  2  2  2  2  2  2  3  2  2  2  2  2